19
19
1 1 1	1 1 1	1 1 1	1 1 1	1 1 1	1 1 1	1 1 1	1 1 1	1 1 1	1 1 1	1 1 1	1 1 1	1 1 1	1 1 1	1 1 1	1 1 1	1 1 1	1 1 1	1 1 1
1 1 1	0 0 0	0 0 0	0 0 0	0 0 0	0 0 0	0 0 0	0 0 0	0 0 0	0 0 0	0 0 0	0 0 0	0 0 0	0 0 0	0 0 0	0 0 0	0 0 0	0 0 0	1 1 1
1 1 1	0 0 0	0 0 0	0 0 0	0 0 0	0 0 0	0 0 0	0 0 0	0 0 0	0 0 0	0 0 0	0 0 0	0 0 0	0 0 0	0 0 0	0 0 0	0 0 0	0 0 0	1 1 1
1 1 1	0 0 0	0 0 0	0 0 0	0 0 0	0 0 0	0 0 0	0 0 0	0 0 0	17 0 0	0 0 0	0 0 0	0 0 0	0 0 0	0 0 0	0 0 0	0 0 0	0 0 0	1 1 1
1 1 1	0 0 0	0 0 0	14 2 3	0 0 0	0 0 0	0 0 0	0 0 0	0 0 0	0 0 0	0 0 0	0 0 0	0 0 0	0 0 0	0 0 0	14 2 3	0 0 0	0 0 0	1 1 1
1 1 1	0 0 0	0 0 0	0 0 0	0 0 0	0 0 0	0 0 0	0 0 0	0 0 0	0 0 0	0 0 0	0 0 0	0 0 0	0 0 0	0 0 0	0 0 0	0 0 0	0 0 0	1 1 1
1 1 1	0 0 0	0 0 0	0 0 0	0 0 0	0 0 0	0 0 0	0 0 0	0 0 0	0 0 0	0 0 0	0 0 0	0 0 0	0 0 0	0 0 0	0 0 0	0 0 0	0 0 0	1 1 1
1 1 1	0 0 0	14 2 3	0 0 0	0 0 0	1 1 1	7 3 4	0 0 0	0 0 0	0 0 0	0 0 0	0 0 0	9 3 4	1 1 1	0 0 0	0 0 0	14 2 3	0 0 0	1 1 1
1 1 1	0 0 0	0 0 0	0 0 0	0 0 0	1 1 1	1 1 1	0 0 0	0 0 0	0 0 0	0 0 0	0 0 0	1 1 1	1 1 1	0 0 0	0 0 0	0 0 0	0 0 0	1 1 1
1 1 1	0 0 0	0 0 0	0 0 0	0 0 0	1 1 1	1 1 1	0 0 0	0 0 0	0 0 0	0 0 0	0 0 0	1 1 1	1 1 1	0 0 0	0 0 0	0 0 0	0 0 0	1 1 1
1 1 1	0 0 0	0 0 0	0 0 0	0 0 0	4 1 2	1 1 1	10 3 5	0 0 0	0 0 0	0 0 0	13 3 5	1 1 1	3 1 2	0 0 0	0 0 0	0 0 0	0 0 0	1 1 1
1 1 1	0 0 0	0 0 0	0 0 0	0 0 0	0 0 0	4 1 2	1 1 1	2 1 2	0 0 0	5 1 2	1 1 1	3 1 2	0 0 0	0 0 0	0 0 0	0 0 0	0 0 0	1 1 1
1 1 1	0 0 0	0 0 0	0 0 0	0 0 0	0 0 0	0 0 0	4 1 2	1 1 1	1 1 1	1 1 1	3 1 2	0 0 0	0 0 0	0 0 0	0 0 0	0 0 0	0 0 0	1 1 1
1 1 1	2 1 2	0 0 0	0 0 0	0 0 0	0 0 0	0 0 0	0 0 0	0 0 0	0 0 0	0 0 0	0 0 0	0 0 0	0 0 0	0 0 0	0 0 0	0 0 0	5 1 2	1 1 1
1 1 1	1 1 1	2 1 2	0 0 0	0 0 0	0 0 0	0 0 0	0 0 0	0 0 0	0 0 0	0 0 0	0 0 0	0 0 0	0 0 0	0 0 0	0 0 0	5 1 2	1 1 1	1 1 1
1 1 1	1 1 1	1 1 1	2 1 2	0 0 0	0 0 0	0 0 0	0 0 0	0 0 0	0 0 0	0 0 0	0 0 0	0 0 0	0 0 0	0 0 0	5 1 2	1 1 1	1 1 1	1 1 1
1 1 1	1 1 1	1 1 1	1 1 1	2 1 2	0 0 0	0 0 0	0 0 0	0 0 0	0 0 0	0 0 0	0 0 0	0 0 0	0 0 0	5 1 2	1 1 1	1 1 1	1 1 1	1 1 1
1 1 1	1 1 1	1 1 1	1 1 1	1 1 1	2 1 2	0 0 0	0 0 0	0 0 0	0 0 0	0 0 0	0 0 0	0 0 0	5 1 2	1 1 1	1 1 1	1 1 1	1 1 1	1 1 1
1 1 1	1 1 1	1 1 1	1 1 1	1 1 1	1 1 1	1 1 1	1 1 1	18 5 1	18 5 1	18 5 1	1 1 1	1 1 1	1 1 1	1 1 1	1 1 1	1 1 1	1 1 1	1 1 1
