27
109
1 1 1	1 1 1	1 1 1	1 1 1	1 1 1	1 1 1	1 1 1	1 1 1	1 1 1	1 1 1	1 1 1	1 1 1	1 1 1	1 1 1	1 1 1	1 1 1	1 1 1	1 1 1	1 1 1	1 1 1	1 1 1	1 1 1	1 1 1	1 1 1	1 1 1	1 1 1	1 1 1
1 1 1	18 5 1	18 5 1	18 5 1	18 5 1	18 5 1	18 5 1	18 5 1	18 5 1	18 5 1	18 5 1	18 5 1	18 5 1	18 5 1	18 5 1	18 5 1	18 5 1	18 5 1	18 5 1	18 5 1	18 5 1	18 5 1	18 5 1	18 5 1	18 5 1	18 5 1	1 1 1
1 1 1	18 5 1	18 5 1	18 5 1	18 5 1	18 5 1	18 5 1	18 5 1	18 5 1	18 5 1	18 5 1	18 5 1	18 5 1	18 5 1	18 5 1	18 5 1	18 5 1	18 5 1	18 5 1	18 5 1	18 5 1	18 5 1	18 5 1	18 5 1	18 5 1	18 5 1	1 1 1
1 1 1	0 0 0	0 0 0	0 0 0	0 0 0	0 0 0	0 0 0	0 0 0	0 0 0	0 0 0	0 0 0	0 0 0	0 0 0	0 0 0	0 0 0	0 0 0	0 0 0	0 0 0	0 0 0	0 0 0	0 0 0	0 0 0	0 0 0	0 0 0	0 0 0	0 0 0	1 1 1
1 1 1	0 0 0	14 2 3	0 0 0	0 0 0	0 0 0	14 2 3	0 0 0	0 0 0	0 0 0	14 2 3	0 0 0	0 0 0	0 0 0	0 0 0	0 0 0	14 2 3	0 0 0	0 0 0	0 0 0	14 2 3	0 0 0	0 0 0	0 0 0	14 2 3	0 0 0	1 1 1
1 1 1	0 0 0	0 0 0	0 0 0	0 0 0	0 0 0	0 0 0	0 0 0	0 0 0	0 0 0	0 0 0	0 0 0	0 0 0	0 0 0	0 0 0	0 0 0	0 0 0	0 0 0	0 0 0	0 0 0	0 0 0	0 0 0	0 0 0	0 0 0	0 0 0	0 0 0	1 1 1
1 1 1	0 0 0	0 0 0	0 0 0	14 2 3	0 0 0	0 0 0	0 0 0	14 2 3	0 0 0	0 0 0	0 0 0	0 0 0	15 4 6	0 0 0	0 0 0	0 0 0	0 0 0	14 2 3	0 0 0	0 0 0	0 0 0	14 2 3	0 0 0	0 0 0	0 0 0	1 1 1
1 1 1	0 0 0	0 0 0	0 0 0	0 0 0	0 0 0	0 0 0	0 0 0	0 0 0	0 0 0	0 0 0	0 0 0	0 0 0	0 0 0	0 0 0	0 0 0	0 0 0	0 0 0	0 0 0	0 0 0	0 0 0	0 0 0	0 0 0	0 0 0	0 0 0	0 0 0	1 1 1
1 1 1	0 0 0	14 2 3	0 0 0	0 0 0	0 0 0	14 2 3	0 0 0	0 0 0	0 0 0	14 2 3	0 0 0	0 0 0	0 0 0	0 0 0	0 0 0	14 2 3	0 0 0	0 0 0	0 0 0	14 2 3	0 0 0	0 0 0	0 0 0	14 2 3	0 0 0	1 1 1
1 1 1	0 0 0	0 0 0	0 0 0	0 0 0	0 0 0	0 0 0	0 0 0	0 0 0	0 0 0	0 0 0	0 0 0	0 0 0	0 0 0	0 0 0	0 0 0	0 0 0	0 0 0	0 0 0	0 0 0	0 0 0	0 0 0	0 0 0	0 0 0	0 0 0	0 0 0	1 1 1
1 1 1	0 0 0	0 0 0	0 0 0	14 2 3	0 0 0	0 0 0	0 0 0	14 2 3	0 0 0	0 0 0	0 0 0	0 0 0	0 0 0	0 0 0	0 0 0	0 0 0	0 0 0	14 2 3	0 0 0	0 0 0	0 0 0	14 2 3	0 0 0	0 0 0	0 0 0	1 1 1
1 1 1	0 0 0	0 0 0	0 0 0	0 0 0	0 0 0	0 0 0	0 0 0	0 0 0	0 0 0	0 0 0	1 1 1	0 0 0	0 0 0	0 0 0	1 1 1	0 0 0	0 0 0	0 0 0	0 0 0	0 0 0	0 0 0	0 0 0	0 0 0	0 0 0	0 0 0	1 1 1
1 1 1	0 0 0	14 2 3	0 0 0	0 0 0	0 0 0	14 2 3	0 0 0	0 0 0	0 0 0	0 0 0	0 0 0	0 0 0	0 0 0	0 0 0	0 0 0	0 0 0	0 0 0	0 0 0	0 0 0	14 2 3	0 0 0	0 0 0	0 0 0	14 2 3	0 0 0	1 1 1
1 1 1	0 0 0	0 0 0	0 0 0	0 0 0	0 0 0	0 0 0	0 0 0	0 0 0	0 0 0	0 0 0	0 0 0	0 0 0	0 0 0	0 0 0	0 0 0	0 0 0	0 0 0	0 0 0	0 0 0	0 0 0	0 0 0	0 0 0	0 0 0	0 0 0	0 0 0	1 1 1
1 1 1	0 0 0	0 0 0	0 0 0	0 0 0	0 0 0	0 0 0	0 0 0	0 0 0	0 0 0	0 0 0	0 0 0	0 0 0	0 0 0	0 0 0	0 0 0	0 0 0	0 0 0	0 0 0	0 0 0	0 0 0	0 0 0	0 0 0	0 0 0	0 0 0	0 0 0	1 1 1
1 1 1	0 0 0	14 2 3	0 0 0	0 0 0	0 0 0	0 0 0	0 0 0	0 0 0	2 1 2	0 0 0	0 0 0	0 0 0	0 0 0	0 0 0	0 0 0	0 0 0	5 1 2	0 0 0	0 0 0	0 0 0	0 0 0	0 0 0	0 0 0	14 2 3	0 0 0	1 1 1
1 1 1	0 0 0	0 0 0	0 0 0	0 0 0	0 0 0	0 0 0	0 0 0	0 0 0	1 1 1	2 1 2	0 0 0	0 0 0	0 0 0	0 0 0	0 0 0	5 1 2	1 1 1	0 0 0	0 0 0	0 0 0	0 0 0	0 0 0	0 0 0	0 0 0	0 0 0	1 1 1
1 1 1	0 0 0	0 0 0	0 0 0	0 0 0	0 0 0	0 0 0	0 0 0	0 0 0	4 1 2	1 1 1	2 1 2	0 0 0	0 0 0	0 0 0	5 1 2	1 1 1	3 1 2	0 0 0	0 0 0	0 0 0	0 0 0	0 0 0	0 0 0	0 0 0	0 0 0	1 1 1
1 1 1	10 3 5	0 0 0	0 0 0	0 0 0	0 0 0	0 0 0	0 0 0	0 0 0	5 1 2	1 1 1	1 1 1	0 0 0	0 0 0	0 0 0	1 1 1	1 1 1	2 1 2	0 0 0	0 0 0	0 0 0	0 0 0	0 0 0	0 0 0	0 0 0	13 3 5	1 1 1
1 1 1	1 1 1	10 3 5	0 0 0	0 0 0	0 0 0	0 0 0	0 0 0	0 0 0	1 1 1	1 1 1	1 1 1	1 1 1	1 1 1	1 1 1	1 1 1	1 1 1	1 1 1	0 0 0	0 0 0	0 0 0	0 0 0	0 0 0	0 0 0	13 3 5	1 1 1	1 1 1
1 1 1	1 1 1	1 1 1	10 3 5	0 0 0	0 0 0	0 0 0	0 0 0	0 0 0	12 3 5	1 1 1	1 1 1	8 3 4	8 3 4	8 3 4	1 1 1	1 1 1	11 3 5	0 0 0	0 0 0	0 0 0	0 0 0	0 0 0	13 3 5	1 1 1	1 1 1	1 1 1
1 1 1	1 1 1	1 1 1	1 1 1	0 0 0	0 0 0	0 0 0	0 0 0	0 0 0	0 0 0	0 0 0	0 0 0	0 0 0	0 0 0	0 0 0	0 0 0	0 0 0	0 0 0	0 0 0	0 0 0	0 0 0	0 0 0	0 0 0	1 1 1	1 1 1	1 1 1	1 1 1
1 1 1	1 1 1	1 1 1	7 3 4	0 0 0	0 0 0	0 0 0	0 0 0	0 0 0	0 0 0	0 0 0	0 0 0	0 0 0	0 0 0	0 0 0	0 0 0	0 0 0	0 0 0	0 0 0	0 0 0	0 0 0	0 0 0	0 0 0	9 3 4	1 1 1	1 1 1	1 1 1
1 1 1	1 1 1	1 1 1	1 1 1	0 0 0	0 0 0	0 0 0	0 0 0	0 0 0	0 0 0	0 0 0	0 0 0	0 0 0	14 2 3	0 0 0	0 0 0	0 0 0	0 0 0	0 0 0	0 0 0	0 0 0	0 0 0	0 0 0	1 1 1	1 1 1	1 1 1	1 1 1
1 1 1	1 1 1	1 1 1	1 1 1	10 3 5	0 0 0	0 0 0	0 0 0	14 2 3	0 0 0	0 0 0	14 2 3	0 0 0	0 0 0	0 0 0	14 2 3	0 0 0	0 0 0	14 2 3	0 0 0	0 0 0	0 0 0	13 3 5	1 1 1	1 1 1	1 1 1	1 1 1
1 1 1	1 1 1	1 1 1	1 1 1	1 1 1	0 0 0	0 0 0	0 0 0	0 0 0	0 0 0	0 0 0	0 0 0	0 0 0	0 0 0	0 0 0	0 0 0	0 0 0	0 0 0	0 0 0	0 0 0	0 0 0	0 0 0	1 1 1	1 1 1	1 1 1	1 1 1	1 1 1
1 1 1	1 1 1	1 1 1	1 1 1	1 1 1	0 0 0	0 0 0	0 0 0	0 0 0	0 0 0	0 0 0	0 0 0	0 0 0	14 2 3	0 0 0	0 0 0	0 0 0	0 0 0	0 0 0	0 0 0	0 0 0	0 0 0	1 1 1	1 1 1	1 1 1	1 1 1	1 1 1
1 1 1	1 1 1	1 1 1	1 1 1	1 1 1	3 1 2	0 0 0	0 0 0	5 1 2	3 1 2	0 0 0	0 0 0	0 0 0	0 0 0	0 0 0	0 0 0	0 0 0	0 0 0	2 1 2	0 0 0	0 0 0	4 1 2	1 1 1	1 1 1	1 1 1	1 1 1	1 1 1
1 1 1	1 1 1	1 1 1	1 1 1	3 1 2	0 0 0	0 0 0	5 1 2	3 1 2	0 0 0	0 0 0	0 0 0	0 0 0	0 0 0	0 0 0	0 0 0	0 0 0	0 0 0	4 1 2	2 1 2	0 0 0	0 0 0	4 1 2	1 1 1	1 1 1	1 1 1	1 1 1
1 1 1	1 1 1	1 1 1	3 1 2	0 0 0	0 0 0	5 1 2	3 1 2	0 0 0	0 0 0	0 0 0	0 0 0	5 1 2	14 2 3	2 1 2	0 0 0	0 0 0	0 0 0	0 0 0	4 1 2	2 1 2	0 0 0	0 0 0	0 0 0	4 1 2	1 1 1	1 1 1
1 1 1	1 1 1	3 1 2	0 0 0	0 0 0	5 1 2	3 1 2	0 0 0	0 0 0	0 0 0	0 0 0	6 3 4	11 3 5	0 0 0	12 3 5	6 3 4	0 0 0	0 0 0	0 0 0	0 0 0	4 1 2	2 1 2	0 0 0	0 0 0	0 0 0	4 1 2	1 1 1
1 1 1	3 1 2	0 0 0	0 0 0	5 1 2	3 1 2	0 0 0	0 0 0	0 0 0	0 0 0	5 1 2	3 1 2	0 0 0	0 0 0	0 0 0	4 1 2	2 1 2	0 0 0	0 0 0	0 0 0	0 0 0	4 1 2	2 1 2	0 0 0	0 0 0	0 0 0	1 1 1
1 1 1	0 0 0	0 0 0	5 1 2	3 1 2	0 0 0	0 0 0	0 0 0	0 0 0	6 3 4	3 1 2	0 0 0	0 0 0	0 0 0	0 0 0	0 0 0	4 1 2	6 3 4	0 0 0	0 0 0	0 0 0	0 0 0	4 1 2	2 1 2	0 0 0	0 0 0	1 1 1
1 1 1	0 0 0	5 1 2	1 1 1	0 0 0	0 0 0	0 0 0	0 0 0	5 1 2	3 1 2	0 0 0	0 0 0	0 0 0	0 0 0	0 0 0	0 0 0	0 0 0	4 1 2	2 1 2	0 0 0	0 0 0	0 0 0	0 0 0	1 1 1	2 1 2	0 0 0	1 1 1
1 1 1	0 0 0	1 1 1	6 3 4	0 0 0	0 0 0	0 0 0	6 3 4	3 1 2	0 0 0	0 0 0	0 0 0	0 0 0	0 0 0	0 0 0	0 0 0	0 0 0	0 0 0	4 1 2	6 3 4	0 0 0	0 0 0	0 0 0	6 3 4	1 1 1	0 0 0	1 1 1
1 1 1	0 0 0	1 1 1	1 1 1	0 0 0	0 0 0	0 0 0	1 1 1	0 0 0	0 0 0	15 4 6	0 0 0	0 0 0	0 0 0	0 0 0	0 0 0	15 4 6	0 0 0	0 0 0	1 1 1	0 0 0	0 0 0	0 0 0	1 1 1	1 1 1	0 0 0	1 1 1
1 1 1	0 0 0	1 1 1	6 3 4	0 0 0	0 0 0	0 0 0	6 3 4	0 0 0	0 0 0	0 0 0	0 0 0	0 0 0	14 2 3	0 0 0	0 0 0	0 0 0	0 0 0	0 0 0	6 3 4	0 0 0	0 0 0	0 0 0	6 3 4	1 1 1	0 0 0	1 1 1
1 1 1	0 0 0	1 1 1	1 1 1	0 0 0	0 0 0	0 0 0	1 1 1	0 0 0	0 0 0	0 0 0	0 0 0	0 0 0	0 0 0	0 0 0	0 0 0	0 0 0	0 0 0	0 0 0	1 1 1	0 0 0	0 0 0	0 0 0	1 1 1	1 1 1	0 0 0	1 1 1
1 1 1	0 0 0	1 1 1	6 3 4	0 0 0	0 0 0	0 0 0	6 3 4	0 0 0	0 0 0	0 0 0	14 2 3	0 0 0	15 4 6	0 0 0	14 2 3	0 0 0	0 0 0	0 0 0	6 3 4	0 0 0	0 0 0	0 0 0	6 3 4	1 1 1	0 0 0	1 1 1
1 1 1	0 0 0	1 1 1	1 1 1	0 0 0	0 0 0	0 0 0	1 1 1	0 0 0	0 0 0	0 0 0	0 0 0	0 0 0	0 0 0	0 0 0	0 0 0	0 0 0	0 0 0	0 0 0	1 1 1	0 0 0	0 0 0	0 0 0	1 1 1	1 1 1	0 0 0	1 1 1
1 1 1	0 0 0	1 1 1	6 3 4	0 0 0	0 0 0	0 0 0	6 3 4	0 0 0	0 0 0	0 0 0	0 0 0	0 0 0	14 2 3	0 0 0	0 0 0	0 0 0	0 0 0	0 0 0	6 3 4	0 0 0	0 0 0	0 0 0	6 3 4	1 1 1	0 0 0	1 1 1
1 1 1	0 0 0	1 1 1	1 1 1	0 0 0	0 0 0	0 0 0	1 1 1	0 0 0	0 0 0	0 0 0	0 0 0	0 0 0	0 0 0	0 0 0	0 0 0	0 0 0	0 0 0	0 0 0	1 1 1	0 0 0	0 0 0	0 0 0	1 1 1	1 1 1	0 0 0	1 1 1
1 1 1	0 0 0	1 1 1	6 3 4	0 0 0	0 0 0	0 0 0	6 3 4	0 0 0	0 0 0	0 0 0	14 2 3	0 0 0	0 0 0	0 0 0	14 2 3	0 0 0	0 0 0	0 0 0	6 3 4	0 0 0	0 0 0	0 0 0	6 3 4	1 1 1	0 0 0	1 1 1
1 1 1	0 0 0	1 1 1	1 1 1	0 0 0	0 0 0	0 0 0	1 1 1	0 0 0	0 0 0	0 0 0	0 0 0	0 0 0	0 0 0	0 0 0	0 0 0	0 0 0	0 0 0	0 0 0	1 1 1	0 0 0	0 0 0	0 0 0	1 1 1	1 1 1	0 0 0	1 1 1
1 1 1	0 0 0	1 1 1	6 3 4	0 0 0	0 0 0	0 0 0	6 3 4	0 0 0	0 0 0	0 0 0	0 0 0	0 0 0	14 2 3	0 0 0	0 0 0	0 0 0	0 0 0	0 0 0	6 3 4	0 0 0	0 0 0	0 0 0	6 3 4	1 1 1	0 0 0	1 1 1
1 1 1	0 0 0	1 1 1	1 1 1	0 0 0	0 0 0	0 0 0	1 1 1	0 0 0	0 0 0	0 0 0	0 0 0	0 0 0	0 0 0	0 0 0	0 0 0	0 0 0	0 0 0	0 0 0	1 1 1	0 0 0	0 0 0	0 0 0	1 1 1	1 1 1	0 0 0	1 1 1
1 1 1	0 0 0	1 1 1	6 3 4	0 0 0	0 0 0	0 0 0	6 3 4	0 0 0	0 0 0	0 0 0	14 2 3	0 0 0	0 0 0	0 0 0	14 2 3	0 0 0	0 0 0	0 0 0	6 3 4	0 0 0	0 0 0	0 0 0	6 3 4	1 1 1	0 0 0	1 1 1
1 1 1	0 0 0	1 1 1	1 1 1	0 0 0	0 0 0	0 0 0	1 1 1	0 0 0	0 0 0	0 0 0	0 0 0	0 0 0	0 0 0	0 0 0	0 0 0	0 0 0	0 0 0	0 0 0	1 1 1	0 0 0	0 0 0	0 0 0	1 1 1	1 1 1	0 0 0	1 1 1
1 1 1	0 0 0	1 1 1	6 3 4	0 0 0	0 0 0	0 0 0	6 3 4	0 0 0	0 0 0	0 0 0	0 0 0	0 0 0	14 2 3	0 0 0	0 0 0	0 0 0	0 0 0	0 0 0	6 3 4	0 0 0	0 0 0	0 0 0	6 3 4	1 1 1	0 0 0	1 1 1
1 1 1	0 0 0	1 1 1	1 1 1	0 0 0	0 0 0	0 0 0	1 1 1	0 0 0	0 0 0	0 0 0	0 0 0	0 0 0	0 0 0	0 0 0	0 0 0	0 0 0	0 0 0	0 0 0	1 1 1	0 0 0	0 0 0	0 0 0	1 1 1	1 1 1	0 0 0	1 1 1
1 1 1	0 0 0	1 1 1	6 3 4	0 0 0	0 0 0	0 0 0	6 3 4	0 0 0	0 0 0	0 0 0	14 2 3	0 0 0	0 0 0	0 0 0	14 2 3	0 0 0	0 0 0	0 0 0	6 3 4	0 0 0	0 0 0	0 0 0	6 3 4	1 1 1	0 0 0	1 1 1
1 1 1	0 0 0	1 1 1	1 1 1	0 0 0	0 0 0	0 0 0	1 1 1	0 0 0	0 0 0	0 0 0	0 0 0	0 0 0	0 0 0	0 0 0	0 0 0	0 0 0	0 0 0	0 0 0	1 1 1	0 0 0	0 0 0	0 0 0	1 1 1	1 1 1	0 0 0	1 1 1
1 1 1	0 0 0	1 1 1	1 1 1	0 0 0	0 0 0	0 0 0	1 1 1	0 0 0	0 0 0	0 0 0	0 0 0	0 0 0	14 2 3	0 0 0	0 0 0	0 0 0	0 0 0	0 0 0	1 1 1	0 0 0	0 0 0	0 0 0	1 1 1	1 1 1	0 0 0	1 1 1
1 1 1	15 4 6	1 1 1	3 1 2	0 0 0	0 0 0	0 0 0	4 1 2	0 0 0	0 0 0	0 0 0	0 0 0	0 0 0	0 0 0	0 0 0	0 0 0	0 0 0	0 0 0	0 0 0	3 1 2	0 0 0	0 0 0	0 0 0	4 1 2	1 1 1	15 4 6	1 1 1
1 1 1	5 1 2	3 1 2	0 0 0	0 0 0	0 0 0	0 0 0	0 0 0	0 0 0	0 0 0	10 3 5	0 0 0	0 0 0	0 0 0	0 0 0	0 0 0	13 3 5	0 0 0	0 0 0	0 0 0	0 0 0	0 0 0	0 0 0	0 0 0	4 1 2	2 1 2	1 1 1
1 1 1	3 1 2	0 0 0	0 0 0	0 0 0	0 0 0	0 0 0	0 0 0	0 0 0	0 0 0	1 1 1	0 0 0	0 0 0	0 0 0	0 0 0	0 0 0	1 1 1	0 0 0	0 0 0	0 0 0	0 0 0	0 0 0	0 0 0	0 0 0	0 0 0	4 1 2	1 1 1
1 1 1	0 0 0	0 0 0	0 0 0	0 0 0	0 0 0	0 0 0	0 0 0	0 0 0	12 3 5	1 1 1	10 3 5	0 0 0	0 0 0	0 0 0	13 3 5	1 1 1	11 3 5	0 0 0	0 0 0	0 0 0	0 0 0	0 0 0	0 0 0	0 0 0	0 0 0	1 1 1
7 3 4	0 0 0	0 0 0	5 1 2	0 0 0	0 0 0	0 0 0	0 0 0	0 0 0	0 0 0	4 1 2	1 1 1	0 0 0	0 0 0	0 0 0	1 1 1	3 1 2	0 0 0	0 0 0	0 0 0	0 0 0	0 0 0	0 0 0	2 1 2	0 0 0	0 0 0	9 3 4
1 1 1	0 0 0	15 4 6	1 1 1	0 0 0	0 0 0	0 0 0	0 0 0	0 0 0	0 0 0	0 0 0	0 0 0	0 0 0	0 0 0	0 0 0	0 0 0	0 0 0	0 0 0	0 0 0	0 0 0	0 0 0	0 0 0	0 0 0	1 1 1	15 4 6	0 0 0	1 1 1
1 1 1	0 0 0	0 0 0	1 1 1	0 0 0	0 0 0	0 0 0	5 1 2	0 0 0	0 0 0	0 0 0	0 0 0	15 4 6	0 0 0	15 4 6	0 0 0	0 0 0	0 0 0	0 0 0	2 1 2	0 0 0	0 0 0	0 0 0	1 1 1	0 0 0	0 0 0	1 1 1
1 1 1	0 0 0	0 0 0	4 1 2	6 3 4	6 3 4	6 3 4	1 1 1	0 0 0	0 0 0	0 0 0	0 0 0	0 0 0	0 0 0	0 0 0	0 0 0	0 0 0	0 0 0	0 0 0	1 1 1	6 3 4	6 3 4	6 3 4	3 1 2	0 0 0	0 0 0	1 1 1
1 1 1	0 0 0	0 0 0	0 0 0	0 0 0	0 0 0	0 0 0	0 0 0	0 0 0	0 0 0	0 0 0	0 0 0	0 0 0	0 0 0	0 0 0	0 0 0	0 0 0	0 0 0	0 0 0	0 0 0	0 0 0	0 0 0	0 0 0	0 0 0	0 0 0	0 0 0	1 1 1
1 1 1	0 0 0	0 0 0	0 0 0	0 0 0	0 0 0	0 0 0	0 0 0	0 0 0	0 0 0	0 0 0	0 0 0	0 0 0	0 0 0	0 0 0	0 0 0	0 0 0	0 0 0	0 0 0	0 0 0	0 0 0	0 0 0	0 0 0	0 0 0	0 0 0	0 0 0	1 1 1
7 3 4	0 0 0	0 0 0	0 0 0	0 0 0	0 0 0	0 0 0	0 0 0	0 0 0	0 0 0	0 0 0	0 0 0	0 0 0	0 0 0	0 0 0	0 0 0	0 0 0	0 0 0	0 0 0	0 0 0	0 0 0	0 0 0	0 0 0	0 0 0	0 0 0	0 0 0	9 3 4
7 3 4	0 0 0	0 0 0	0 0 0	0 0 0	0 0 0	0 0 0	0 0 0	0 0 0	0 0 0	0 0 0	5 1 2	0 0 0	0 0 0	0 0 0	2 1 2	0 0 0	0 0 0	0 0 0	0 0 0	0 0 0	0 0 0	0 0 0	0 0 0	0 0 0	0 0 0	9 3 4
7 3 4	0 0 0	0 0 0	0 0 0	0 0 0	0 0 0	0 0 0	0 0 0	0 0 0	0 0 0	0 0 0	1 1 1	0 0 0	0 0 0	0 0 0	1 1 1	0 0 0	0 0 0	0 0 0	0 0 0	0 0 0	0 0 0	0 0 0	0 0 0	0 0 0	0 0 0	9 3 4
1 1 1	0 0 0	0 0 0	0 0 0	0 0 0	0 0 0	0 0 0	0 0 0	0 0 0	0 0 0	13 3 5	1 1 1	0 0 0	14 2 3	0 0 0	1 1 1	10 3 5	0 0 0	0 0 0	0 0 0	0 0 0	0 0 0	0 0 0	0 0 0	0 0 0	0 0 0	1 1 1
1 1 1	0 0 0	0 0 0	0 0 0	14 2 3	0 0 0	0 0 0	0 0 0	0 0 0	13 3 5	1 1 1	1 1 1	0 0 0	0 0 0	0 0 0	1 1 1	1 1 1	10 3 5	0 0 0	0 0 0	0 0 0	0 0 0	14 2 3	0 0 0	0 0 0	0 0 0	1 1 1
1 1 1	0 0 0	0 0 0	0 0 0	0 0 0	0 0 0	0 0 0	0 0 0	0 0 0	1 1 1	1 1 1	1 1 1	0 0 0	0 0 0	0 0 0	1 1 1	1 1 1	1 1 1	0 0 0	0 0 0	0 0 0	0 0 0	0 0 0	0 0 0	0 0 0	0 0 0	1 1 1
1 1 1	0 0 0	0 0 0	0 0 0	0 0 0	0 0 0	0 0 0	0 0 0	13 3 5	1 1 1	1 1 1	1 1 1	0 0 0	0 0 0	0 0 0	1 1 1	1 1 1	1 1 1	10 3 5	0 0 0	0 0 0	0 0 0	0 0 0	0 0 0	0 0 0	0 0 0	1 1 1
1 1 1	0 0 0	0 0 0	0 0 0	0 0 0	0 0 0	0 0 0	0 0 0	4 1 2	1 1 1	1 1 1	7 3 4	0 0 0	0 0 0	0 0 0	9 3 4	1 1 1	1 1 1	3 1 2	0 0 0	0 0 0	0 0 0	0 0 0	0 0 0	0 0 0	0 0 0	1 1 1
1 1 1	0 0 0	0 0 0	0 0 0	0 0 0	0 0 0	0 0 0	0 0 0	0 0 0	1 1 1	1 1 1	1 1 1	0 0 0	0 0 0	0 0 0	1 1 1	1 1 1	1 1 1	0 0 0	0 0 0	0 0 0	0 0 0	0 0 0	0 0 0	0 0 0	0 0 0	1 1 1
1 1 1	0 0 0	0 0 0	0 0 0	0 0 0	0 0 0	0 0 0	0 0 0	0 0 0	4 1 2	1 1 1	1 1 1	0 0 0	0 0 0	0 0 0	1 1 1	1 1 1	3 1 2	0 0 0	0 0 0	0 0 0	0 0 0	0 0 0	0 0 0	0 0 0	0 0 0	1 1 1
1 1 1	10 3 5	0 0 0	0 0 0	0 0 0	0 0 0	0 0 0	0 0 0	0 0 0	0 0 0	4 1 2	1 1 1	0 0 0	0 0 0	0 0 0	1 1 1	3 1 2	0 0 0	0 0 0	0 0 0	0 0 0	0 0 0	0 0 0	0 0 0	0 0 0	13 3 5	1 1 1
1 1 1	1 1 1	10 3 5	0 0 0	0 0 0	0 0 0	0 0 0	0 0 0	0 0 0	0 0 0	0 0 0	0 0 0	0 0 0	0 0 0	0 0 0	0 0 0	0 0 0	0 0 0	0 0 0	0 0 0	0 0 0	0 0 0	0 0 0	0 0 0	13 3 5	1 1 1	1 1 1
1 1 1	1 1 1	1 1 1	10 3 5	0 0 0	0 0 0	0 0 0	0 0 0	0 0 0	0 0 0	0 0 0	0 0 0	0 0 0	0 0 0	0 0 0	0 0 0	0 0 0	0 0 0	0 0 0	0 0 0	0 0 0	0 0 0	0 0 0	13 3 5	1 1 1	1 1 1	1 1 1
1 1 1	1 1 1	1 1 1	1 1 1	10 3 5	0 0 0	0 0 0	0 0 0	14 2 3	0 0 0	0 0 0	0 0 0	0 0 0	0 0 0	0 0 0	0 0 0	0 0 0	0 0 0	14 2 3	0 0 0	0 0 0	0 0 0	13 3 5	1 1 1	1 1 1	1 1 1	1 1 1
1 1 1	1 1 1	1 1 1	1 1 1	7 3 4	0 0 0	0 0 0	0 0 0	0 0 0	15 4 6	0 0 0	0 0 0	0 0 0	0 0 0	0 0 0	0 0 0	0 0 0	15 4 6	0 0 0	0 0 0	0 0 0	0 0 0	9 3 4	1 1 1	1 1 1	1 1 1	1 1 1
1 1 1	1 1 1	1 1 1	1 1 1	3 1 2	0 0 0	0 0 0	0 0 0	0 0 0	0 0 0	0 0 0	0 0 0	0 0 0	15 4 6	0 0 0	0 0 0	0 0 0	0 0 0	0 0 0	0 0 0	0 0 0	0 0 0	4 1 2	1 1 1	1 1 1	1 1 1	1 1 1
1 1 1	1 1 1	1 1 1	3 1 2	0 0 0	0 0 0	0 0 0	0 0 0	0 0 0	0 0 0	0 0 0	0 0 0	0 0 0	0 0 0	0 0 0	0 0 0	0 0 0	0 0 0	0 0 0	0 0 0	0 0 0	0 0 0	0 0 0	4 1 2	1 1 1	1 1 1	1 1 1
1 1 1	1 1 1	3 1 2	0 0 0	0 0 0	0 0 0	0 0 0	0 0 0	0 0 0	0 0 0	14 2 3	0 0 0	0 0 0	0 0 0	0 0 0	0 0 0	14 2 3	0 0 0	0 0 0	0 0 0	0 0 0	0 0 0	0 0 0	0 0 0	4 1 2	1 1 1	1 1 1
1 1 1	3 1 2	0 0 0	0 0 0	0 0 0	0 0 0	0 0 0	0 0 0	0 0 0	0 0 0	0 0 0	0 0 0	0 0 0	0 0 0	0 0 0	0 0 0	0 0 0	0 0 0	0 0 0	0 0 0	0 0 0	0 0 0	0 0 0	0 0 0	0 0 0	4 1 2	1 1 1
1 1 1	0 0 0	0 0 0	0 0 0	0 0 0	0 0 0	0 0 0	0 0 0	0 0 0	0 0 0	0 0 0	0 0 0	0 0 0	0 0 0	0 0 0	0 0 0	0 0 0	0 0 0	0 0 0	0 0 0	0 0 0	0 0 0	0 0 0	0 0 0	0 0 0	0 0 0	1 1 1
1 1 1	0 0 0	0 0 0	0 0 0	0 0 0	0 0 0	0 0 0	0 0 0	0 0 0	0 0 0	0 0 0	0 0 0	0 0 0	0 0 0	0 0 0	0 0 0	0 0 0	0 0 0	0 0 0	0 0 0	0 0 0	0 0 0	0 0 0	0 0 0	0 0 0	0 0 0	1 1 1
1 1 1	0 0 0	0 0 0	0 0 0	0 0 0	1 1 1	1 1 1	6 3 4	0 0 0	0 0 0	0 0 0	0 0 0	13 3 5	0 0 0	10 3 5	0 0 0	0 0 0	0 0 0	0 0 0	6 3 4	1 1 1	1 1 1	0 0 0	0 0 0	0 0 0	0 0 0	1 1 1
1 1 1	0 0 0	0 0 0	0 0 0	0 0 0	0 0 0	0 0 0	0 0 0	0 0 0	0 0 0	0 0 0	0 0 0	0 0 0	14 2 3	0 0 0	0 0 0	0 0 0	0 0 0	0 0 0	0 0 0	0 0 0	0 0 0	0 0 0	0 0 0	0 0 0	0 0 0	1 1 1
1 1 1	0 0 0	0 0 0	0 0 0	0 0 0	0 0 0	0 0 0	0 0 0	0 0 0	0 0 0	0 0 0	0 0 0	4 1 2	0 0 0	3 1 2	0 0 0	0 0 0	0 0 0	0 0 0	0 0 0	0 0 0	0 0 0	0 0 0	0 0 0	0 0 0	0 0 0	1 1 1
1 1 1	0 0 0	0 0 0	0 0 0	0 0 0	0 0 0	0 0 0	0 0 0	0 0 0	0 0 0	0 0 0	0 0 0	0 0 0	0 0 0	0 0 0	0 0 0	0 0 0	0 0 0	0 0 0	0 0 0	0 0 0	0 0 0	0 0 0	0 0 0	0 0 0	0 0 0	1 1 1
1 1 1	0 0 0	0 0 0	14 2 3	0 0 0	0 0 0	0 0 0	0 0 0	0 0 0	0 0 0	0 0 0	0 0 0	0 0 0	0 0 0	0 0 0	0 0 0	0 0 0	0 0 0	0 0 0	0 0 0	0 0 0	0 0 0	0 0 0	14 2 3	0 0 0	0 0 0	1 1 1
1 1 1	0 0 0	0 0 0	0 0 0	0 0 0	0 0 0	0 0 0	0 0 0	0 0 0	0 0 0	0 0 0	0 0 0	0 0 0	0 0 0	0 0 0	0 0 0	0 0 0	0 0 0	0 0 0	0 0 0	0 0 0	0 0 0	0 0 0	0 0 0	0 0 0	0 0 0	1 1 1
1 1 1	0 0 0	0 0 0	0 0 0	0 0 0	0 0 0	0 0 0	0 0 0	0 0 0	1 1 1	6 3 4	6 3 4	0 0 0	0 0 0	0 0 0	6 3 4	6 3 4	1 1 1	0 0 0	0 0 0	0 0 0	0 0 0	0 0 0	0 0 0	0 0 0	0 0 0	1 1 1
1 1 1	0 0 0	0 0 0	0 0 0	0 0 0	0 0 0	0 0 0	5 1 2	0 0 0	3 1 2	0 0 0	0 0 0	0 0 0	0 0 0	0 0 0	0 0 0	0 0 0	4 1 2	0 0 0	2 1 2	0 0 0	0 0 0	0 0 0	0 0 0	0 0 0	0 0 0	1 1 1
1 1 1	0 0 0	0 0 0	0 0 0	0 0 0	0 0 0	13 3 5	1 1 1	0 0 0	0 0 0	0 0 0	0 0 0	0 0 0	0 0 0	0 0 0	0 0 0	0 0 0	0 0 0	0 0 0	1 1 1	10 3 5	0 0 0	0 0 0	0 0 0	0 0 0	0 0 0	1 1 1
1 1 1	0 0 0	0 0 0	0 0 0	1 1 1	1 1 1	1 1 1	3 1 2	0 0 0	0 0 0	0 0 0	0 0 0	0 0 0	0 0 0	0 0 0	0 0 0	0 0 0	0 0 0	0 0 0	4 1 2	1 1 1	1 1 1	1 1 1	0 0 0	0 0 0	0 0 0	1 1 1
1 1 1	0 0 0	0 0 0	0 0 0	0 0 0	0 0 0	0 0 0	0 0 0	0 0 0	0 0 0	15 4 6	0 0 0	0 0 0	0 0 0	0 0 0	0 0 0	15 4 6	0 0 0	0 0 0	0 0 0	0 0 0	0 0 0	0 0 0	0 0 0	0 0 0	0 0 0	1 1 1
1 1 1	0 0 0	0 0 0	0 0 0	0 0 0	0 0 0	0 0 0	0 0 0	0 0 0	0 0 0	0 0 0	0 0 0	0 0 0	0 0 0	0 0 0	0 0 0	0 0 0	0 0 0	0 0 0	0 0 0	0 0 0	0 0 0	0 0 0	0 0 0	0 0 0	0 0 0	1 1 1
7 3 4	0 0 0	0 0 0	0 0 0	0 0 0	0 0 0	15 4 6	0 0 0	0 0 0	0 0 0	0 0 0	0 0 0	0 0 0	0 0 0	0 0 0	0 0 0	0 0 0	0 0 0	0 0 0	0 0 0	15 4 6	0 0 0	0 0 0	0 0 0	0 0 0	0 0 0	9 3 4
1 1 1	0 0 0	0 0 0	0 0 0	0 0 0	0 0 0	0 0 0	0 0 0	0 0 0	0 0 0	0 0 0	0 0 0	0 0 0	14 2 3	0 0 0	0 0 0	0 0 0	0 0 0	0 0 0	0 0 0	0 0 0	0 0 0	0 0 0	0 0 0	0 0 0	0 0 0	1 1 1
1 1 1	0 0 0	0 0 0	0 0 0	14 2 3	0 0 0	0 0 0	0 0 0	0 0 0	0 0 0	0 0 0	0 0 0	14 2 3	14 2 3	14 2 3	0 0 0	0 0 0	0 0 0	0 0 0	0 0 0	0 0 0	0 0 0	14 2 3	0 0 0	0 0 0	0 0 0	1 1 1
1 1 1	0 0 0	0 0 0	14 2 3	14 2 3	0 0 0	0 0 0	0 0 0	14 2 3	0 0 0	0 0 0	14 2 3	14 2 3	0 0 0	14 2 3	14 2 3	0 0 0	0 0 0	14 2 3	0 0 0	0 0 0	0 0 0	14 2 3	14 2 3	0 0 0	0 0 0	1 1 1
1 1 1	0 0 0	0 0 0	14 2 3	14 2 3	0 0 0	0 0 0	0 0 0	0 0 0	0 0 0	0 0 0	0 0 0	14 2 3	14 2 3	14 2 3	0 0 0	0 0 0	0 0 0	0 0 0	0 0 0	0 0 0	0 0 0	14 2 3	14 2 3	0 0 0	0 0 0	1 1 1
1 1 1	0 0 0	0 0 0	0 0 0	0 0 0	0 0 0	0 0 0	0 0 0	0 0 0	0 0 0	0 0 0	0 0 0	0 0 0	14 2 3	0 0 0	0 0 0	0 0 0	0 0 0	0 0 0	0 0 0	0 0 0	0 0 0	0 0 0	0 0 0	0 0 0	0 0 0	1 1 1
1 1 1	0 0 0	0 0 0	0 0 0	0 0 0	0 0 0	0 0 0	0 0 0	0 0 0	0 0 0	0 0 0	0 0 0	0 0 0	0 0 0	0 0 0	0 0 0	0 0 0	0 0 0	0 0 0	0 0 0	0 0 0	0 0 0	0 0 0	0 0 0	0 0 0	0 0 0	1 1 1
1 1 1	0 0 0	0 0 0	0 0 0	0 0 0	0 0 0	0 0 0	0 0 0	0 0 0	0 0 0	0 0 0	0 0 0	0 0 0	16 4 7	0 0 0	0 0 0	0 0 0	0 0 0	0 0 0	0 0 0	0 0 0	0 0 0	0 0 0	0 0 0	0 0 0	0 0 0	1 1 1
7 3 4	0 0 0	0 0 0	0 0 0	0 0 0	0 0 0	0 0 0	0 0 0	0 0 0	0 0 0	0 0 0	0 0 0	0 0 0	17 0 0	0 0 0	0 0 0	0 0 0	0 0 0	0 0 0	0 0 0	0 0 0	0 0 0	0 0 0	0 0 0	0 0 0	0 0 0	9 3 4
1 1 1	0 0 0	0 0 0	0 0 0	0 0 0	0 0 0	0 0 0	0 0 0	0 0 0	0 0 0	0 0 0	0 0 0	0 0 0	0 0 0	0 0 0	0 0 0	0 0 0	0 0 0	0 0 0	0 0 0	0 0 0	0 0 0	0 0 0	0 0 0	0 0 0	0 0 0	1 1 1
1 1 1	0 0 0	0 0 0	0 0 0	0 0 0	0 0 0	0 0 0	0 0 0	0 0 0	0 0 0	0 0 0	0 0 0	0 0 0	0 0 0	0 0 0	18 5 1	18 5 1	0 0 0	0 0 0	0 0 0	0 0 0	0 0 0	0 0 0	0 0 0	0 0 0	0 0 0	1 1 1
1 1 1	2 1 2	0 0 0	0 0 0	0 0 0	0 0 0	0 0 0	5 1 2	2 1 2	0 0 0	0 0 0	0 0 0	0 0 0	0 0 0	0 0 0	0 0 0	0 0 0	0 0 0	5 1 2	2 1 2	0 0 0	0 0 0	0 0 0	0 0 0	0 0 0	5 1 2	1 1 1
1 1 1	1 1 1	1 1 1	6 3 4	6 3 4	1 1 1	1 1 1	1 1 1	1 1 1	1 1 1	1 1 1	1 1 1	1 1 1	1 1 1	1 1 1	1 1 1	1 1 1	1 1 1	1 1 1	1 1 1	1 1 1	1 1 1	6 3 4	6 3 4	1 1 1	1 1 1	1 1 1
