29
29
1   1   1   1   1   1   1   1   1   1   1   1   8   8   8   1   1   1   1   1   1   1   1   1   1   1   1   1   1
1   1   1   1   1   3   0   0   0   0   0   0   0   0   0   0   0   0   0   0   0   0   0   4   1   1   1   1   1
1   1   1   1   11  0   0   0   0   0   0   0   0   0   0   0   0   0   0   0   0   0   0   0   12  1   1   1   1
1   1   1   11  0   0   0   0   0   0   0   0   0   17  0   0   0   0   0   0   0   0   0   0   0   12  1   1   1
1   1   11  0   0   0   0   0   0   0   0   0   0   0   0   0   0   0   0   0   0   0   0   0   0   0   12  1   1
1   11  0   0   0   0   0   0   0   0   0   0   0   0   0   0   0   0   0   0   0   0   0   0   0   0   0   4   1
1   0   0   0   0   0   0   0   0   0   0   0   0   0   0   0   1   0   0   0   0   0   0   0   0   0   0   0   1
1   0   0   0   0   0   15  0   0   0   0   0   0   0   0   1   0   0   0   0   0   0   16  0   0   0   0   0   1
1   0   0   0   0   0   0   0   0   0   0   0   0   0   0   0   0   0   0   0   0   0   0   0   0   0   0   0   1
1   0   0   0   0   0   0   0   0   0   0   0   0   0   0   0   0   0   0   0   0   0   0   0   0   0   0   0   1
1   0   0   0   0   0   0   0   0   0   0   0   0   0   0   0   0   0   0   0   0   0   0   0   0   0   0   0   1
1   0   0   0   0   0   0   0   0   0   0   0   0   0   0   0   0   0   0   0   0   0   0   0   0   0   0   0   1
1   0   0   0   0   0   0   0   0   0   0   0   0   14  0   0   0   0   0   0   0   0   0   0   0   0   0   0   1
7   0   0   0   0   0   0   0   0   0   0   0   14  14  14  0   0   0   0   0   0   0   0   0   0   0   0   0   9
7   0   0   0   0   0   0   0   0   0   0   0   0   14  0   0   0   0   0   0   0   0   0   0   0   0   0   0   9
7   0   0   0   0   0   0   0   0   0   0   0   0   0   0   0   0   0   0   0   0   0   0   0   0   0   0   0   9
1   0   0   0   0   0   0   0   0   0   0   0   0   0   0   0   0   0   0   0   0   0   0   0   0   0   0   0   1
1   0   0   0   0   0   0   0   0   0   0   0   0   0   0   0   0   0   0   0   0   0   0   0   0   0   0   0   1
1   0   0   0   0   0   0   0   0   0   0   0   0   0   0   0   0   0   0   0   0   0   0   0   0   0   0   0   1
1   0   0   0   0   0   0   0   0   0   0   0   0   0   0   0   0   0   0   0   0   0   0   0   0   0   0   0   1
1   0   0   0   0   0   0   0   0   0   0   0   0   0   0   0   0   0   0   0   0   0   0   0   0   0   0   0   1
1   0   0   0   0   0   0   0   0   0   0   0   0   0   0   0   0   0   0   0   0   0   0   0   0   0   0   0   1
1   0   0   0   0   0   0   0   0   0   0   0   0   0   0   0   0   0   0   0   0   0   0   0   0   0   0   0   1
1   2   0   0   0   0   0   0   0   0   0   0   0   0   0   0   0   0   0   0   0   0   0   0   0   0   0   5   1
1   1   10  0   0   0   0   0   0   0   0   0   0   0   0   0   0   0   0   0   0   0   0   0   0   0   13  1   1
1   1   1   10  0   0   0   0   0   0   0   0   0   0   0   0   0   0   0   0   0   0   0   0   0   13  1   1   1
1   1   1   1   10  0   0   0   0   0   0   0   0   0   0   0   0   0   0   0   0   0   0   0   13  1   1   1   1
1   1   1   1   1   2   0   0   0   0   0   0   0   0   0   0   0   0   0   0   0   0   0   5   1   1   1   1   1
1   1   1   1   1   1   1   1   1   1   1   1   1   18  1   1   1   1   1   1   1   1   1   1   1   1   1   1   1